XXXXXXXXXX
X  S | XSX
X    X X-X
XXSX X X X
X    X X X
X XXXX   X
X    XXXXX
XXX    XXX
XE  X  XXX
XXXXXXXXXX
